La	La
rolo	rol'o
de	de
mezkapabluloj	mez'kapabl'ul'oj
en	en
Esperanto	Esperant'o
movado	mov'ad'o
La	La
8-an	8-an
de	de
septembro	septembr'o
2020	2020
forpasis	for'pas'is
Zlatko	Zlatko
Tišljar	Tišljar
honora	honor'a
membro	membr'o
de	de
UEA	UEA
Memore	Memor'e
al	al
li	li
Libera	Liber'a
Folio	Foli'o
republikigas	re'publik'ig'as
unu	unu
el	el
liaj	li'aj
plej	plej
konataj	kon'at'aj
tekstoj	tekst'oj
La	La
rolo	rol'o
de	de
mezkapabluloj	mez'kapabl'ul'oj
en	en
Esperanto	Esperant'o
movado	mov'ad'o
aperintan	aper'int'an
en	en
la	la
revuo	revu'o
Tempo	Temp'o
en	en
1982	1982
En	En
malgrandaj	mal'grand'aj
sociaj	soci'aj
grupoj	grup'oj
kiel	kiel
interalie	inter'ali'e
ankaŭ	ankaŭ
en	en
la	la
Esperanto	Esperant'o
movado	mov'ad'o
estas	est'as
ankaŭ	ankaŭ
malmultaj	mal'mult'aj
supertalentitaj	super'talent'it'aj
geniaj	geni'aj
personoj	person'oj
Treege	Tre'eg'e
talentitaj	talent'it'aj
homoj	hom'oj
ne	ne
estas	est'as
fenomeno	fenomen'o
kiu	kiu
regule	regul'e
aperas	aper'as
en	en
baza	baz'a
organiza	organiz'a
unuo	unu'o
de	de
nia	ni'a
Esperanto	Esperant'o
komunumo	komun'um'o
en	en
Esperanta	Esperant'a
societo	soci'et'o
Tial	Tial
en	en
ili	ili
la	la
gvidan	gvid'an
pozicion	pozici'on
transprenas	trans'pren'as
mezkapablaj	mez'kapabl'aj
homoj	hom'oj
Talentuloj	Talent'ul'oj
aperas	aper'as
de	de
tempo	temp'o
al	al
tempo	temp'o
sur	sur
landa	land'a
nivelo	nivel'o
Ĉar	Ĉar
la	la
esperantistoj	esperant'ist'oj
samtempe	sam'temp'e
vivas	viv'as
en	en
pli	pli
vasta	vast'a
socia	soci'a
grupo	grup'o
ilia	ili'a
nacio	naci'o
kaj	kaj
en	en
tiu	tiu
pli	pli
vasta	vast'a
socio	soci'o
la	la
mezkapabluloj	mez'kapabl'ul'oj
havas	hav'as
sian	si'an
mezan	mez'an
pozicion	pozici'on
sekve	sekv'e
ne	ne
la	la
gvidan	gvid'an
ili	ili
restas	rest'as
tie	tie
grizaj	griz'aj
ĉiutaguloj	ĉiu'tag'ul'oj
sen	sen
apartaj	apart'aj
sukcesoj	sukces'oj
kaj	kaj
aŭtoritato	aŭtoritat'o
Sed	Sed
en	en
Esperanto	Esperant'o
societo	soci'et'o
pro	pro
relativa	relativ'a
bagateleco	bagatel'ec'o
kaj	kaj
ĉefe	ĉef'e
pro	pro
eventuale	eventual'e
pli	pli
bona	bon'a
lingva	lingv'a
kapablo	kapabl'o
ol	ol
aliaj	ali'aj
ili	ili
fariĝas	far'iĝ'as
pli	pli
aŭ	aŭ
malpli	mal'pli
grandaj	grand'aj
aŭtoritatuloj	aŭtoritat'ul'oj
Se	Se
foje	foj'e
homo	hom'o
kiu	kiu
en	en
la	la
kutima	kutim'a
nacia	naci'a
medio	medi'o
signifas	signif'as
nenion	neni'on
eksentas	ek'sent'as
la	la
dolĉon	dolĉ'on
de	de
aŭtoritata	aŭtoritat'a
povo	pov'o
de	de
eventuala	eventual'a
admirado	ad'mir'ad'o
flanke	flank'e
de	de
la	la
subuloj	sub'ul'oj
estas	est'as
normale	normal'e
ke	ke
ties	ties
ambicioj	ambici'oj
subite	subit'e
kreskas	kresk'as

Tiaj homoj fariĝas senskrupulaj ekstermantoj de ĉio, kio povus endanĝerigi tian ilian pozicion. Se hazarde en iu societo aperas pli kapabla homo, ekstreme talentita, ili entreprenas ĉion por amarigi ties vivon kaj forpeli lin/ŝin el la Movado.

Kaj plej ofte ili sukcesas en tio, ĉar tiuj talentitaj baldaŭ komprenas, ke iliaj valoroj havas multe pli da ŝanco esprimiĝi en la pli vasta nacia skalo ol en tiu sekte enfermita areo, kiun diktatoras unuopaj mezkapabluloj. Nu, tia “reganta klaso” en la Esperanto-movado organiziĝas ankaŭ sur landa kaj eĉ internacia niveloj kaj la organizaj strukturoj sekve plene rigidiĝas praktike malebligante al alte kvalitaj personoj ie ajn esprimiĝi.

Tia strukturo ebligas eĉ al unuopaj personoj iom escepte talentaj sed pro ia kaŭzo ekskomunikitaj el la nacia socio ruze ŝajnigante mezkapablulon, atingi la pinton de la hierarkia piramido kaj tiam plene ekdiktatori. Per siaj pli altaj kapabloj inter la mezkapabluloj ili havas senduban aŭtoritaton kaj komprenante la strukturon ili porbatalas ĝin, fariĝas eksponantoj de tia “reganta mezkapablula klaso” kaj ne timas konkurencon.

Por iom mildigi la situacion almenaŭ sur la internacia nivelo, kie troviĝas la ununura punkto, en kiu la Esperanto-komunumo permesas tuŝi la eksteran mondon (ĉar ja ankaŭ ni bezonas akceptojn ĉe la urbestroj kaj tie nin devas reprezenti iom pli inteligentaj gvidantoj), en la strukturo oni elpensis C-komitatanojn, kiuj estas elektataj rekte en la superan pozicion kaj tiel eblas, ke en la plej superaj institucioj de la Movado (komitatoj kaj estraroj) ni povas havi vere talentajn homojn ‒ sed nur, se ili defendas la interesojn de nia “reganta klaso”. En la momento, kiam ili ne plu volas tion, la Movado trovas manieron anstataŭigi ilin.

Kaj tiel harmonie ni vivas nian vivon en nia propra kaĝo jam cent jarojn. Ni produktas mezkapablajn gvidantojn, kiuj zorgas, ke la Movado ne pliampleksiĝu (ĉar tiam ne plu estus kontrolebla la eniro de talentuloj), ni produktas mezkapablan tavolon de literaturistoj (duono de nia “popolo” konsideras sin verkistoj, recenzistoj, lingvistoj).

Kaj jen la kaŭzo, pro kiu Esperanto havas malgrandan ŝancon fariĝi internacia monda lingvo. La Movado efektive kontraŭbatalas la antaŭenmarŝon de Esperanto, kontraŭbatalas tion en la epoko, kiam efektive prezentiĝas tre bona ŝanco por ĝi ‒ kiam oni ĉiam pli konsciiĝas pri la lingva problemo kaj serĉas solvojn.

Tamen ekzistas truo en tiu sektomuro. Ĝi estas la junularo. Tie, kie la gejunuloj hazarde havis la ŝancon memstare organiziĝi (ĉu en iu plene junulara aŭ studenta klubo, ĉu en landa junulara aŭ eĉ internacia organizo). En junularaj rondoj ankoraŭ oni ne konscias pri la “neceso” flati siajn mezkapablulojn kaj eblas, ke ili elstarigu vere talentajn homojn, kiuj ekribelos kontraŭ tiel establita ordo. Ĉiuj ribeloj, kiuj en la ĝisnuna Esperanto-historio skuis ties mondeton, estis kaŭzitaj de gejunuloj.

Sed, feliĉe por la “sankta ordo”, ĝis nun la institucioj ĉiam sukcesis venki tiujn ribelojn kaj forigi el nia “komunumo” la ribelantojn aŭ aliigi ilin je defendantoj de la sistemo. Kelkloke la breĉoj tamen ne estis ŝtopitaj kaj certe la plej danĝeran aspekton, kiu serioze endanĝerigas la strukturojn, prezentas la profesia poresperanta agado. Ĉar en la profesia agado nepre devas partopreni kapablaj homoj, kiuj povos rilati kun la ekstero kaj en la normala ekonomia konkurenco elbatali por si ekzistorajton.

Tiuj nestoj de iom pli kapablaj nepre signifas mortodanĝeron por la trankvila ĉasareo de la mezkapabluloj. Homoj el profesiaj organizaĵoj kaj entreprenoj komprenos la problemon kaj kontraŭbatalos ĝin, batalos por la malfermo de la Movado, por amasa alfluo de novuloj, por eniro en la naciajn publikajn vivojn, por normala pozicio en tiuj naciaj vivoj, ĉar nur tio povas certigi la pluekziston kaj evoluon de la profesia agado kaj kapitalakumulado.

Sed tio ekstermos la nunan Movadon, ekstermos la privilegiojn kaj la regpotencojn de la mezkapabluloj ‒ ne tuj, ne per unu bato, sed iom post iom ‒ kaj certe!