16-an	16-an
24-a	24-a
Anonimulo	Anonim'ul'o
Ĉar	Ĉar
Ĉi	Ĉi
Ĉu	Ĉu
Eble	Ebl'e
En	En
Esperanto	Esperant'o
Esperantujo	Esperant'uj'o
Facebook	Facebook
Folio	Foli'o
Google-formularo	Google-formularo
Ĝi	Ĝi
Ili	Ili
Instagram	Instagram
Inter	Inter
Jes	Jes
Kaj	Kaj
Kiajn	Kia'jn
Kial	Kial
Kiam	Kiam
Kiel	Kiel
La	La
Libera	Liber'a
Mi	Mi
Mia	Mi'a
Ni	Ni
Oni	Oni
PostSecret	PostSecret
Pri	Pri
Sed	Sed
Sekretoj	Sekret'oj
Tiam	Tiam
Tion	Tio'n
Verŝajne	Ver'ŝajn'e
Vi	Vi
absolute	absolut'e
administranto	administr'ant'o
afero	afer'o
aferojn	afer'ojn
al	al
alskribi	al'skrib'i
alia	ali'a
aliaj	ali'aj
ankaŭ	ankaŭ
anonima	anonim'a
anonime	anonim'e
anonimulo	anonim'ul'o
anonimulon	anonim'ul'on
anstataŭ	anstataŭ
aparte	apart'e
aperis	aper'is
arta	art'a
aŭ	aŭ
bezonos	bezon'os
bona	bon'a
certas	cert'as
certi	cert'i
ĉesos	ĉes'os
ĉi	ĉi
ĉiuj	ĉiu'j
ĉu	ĉu
da	da
de	de
decidis	decid'is
demandas	demand'as
demandis	demand'is
demando	demand'o
diferencoj	diferenc'oj
diros	dir'os
diskonigi	dis'kon'ig'i
disvastigu	dis'vast'ig'u
diskuto	diskut'o
do	do
dum	dum
ekde	ek'de
eku	ek'u
ekpublikigos	ek'publik'ig'os
empation	empati'on
en	en
enhavas	en'hav'as
enorda	en'ord'a
esperas	esper'as
espero	esper'o
esperantistoj	esperant'ist'oj
estas	est'as
esti	est'i
estis	est'is
estos	est'os
estu	est'u
fari	far'i
fidi	fid'i
fizike	fizik'e
foriras	for'ir'as
freŝe	freŝ'e
grava	grav'a
gravan	grav'an
ĝi	ĝi
ĝis	ĝis
hastas	hast'as
havas	hav'as
havis	hav'is
havu	hav'u
helpas	help'as
helpi	help'i
homoj	hom'oj
homojn	hom'ojn
iam	iam
ideo	ide'o
ideojn	ide'ojn
identeco	ident'ec'o
identecoj	ident'ec'oj
iel	iel
ies	ies
ili	ili
iliaj	ili'aj
ilin	ili'n
imagas	imag'as
indikojn	indik'ojn
influis	influ'is
inspirita	inspir'it'a
interrete	inter'ret'e
io	io
ion	io'n
iom	iom
iu	iu
iun	iu'n
ja	ja
jam	jam
juĝojn	juĝ'ojn
kaj	kaj
kaŝita	kaŝ'it'a
ke	ke
kelkajn	kelk'ajn
kiajn	kia'jn
kial	kial
kialo	kial'o
kiam	kiam
kiel	kiel
kio	kio
kiu	kiu
kiuj	kiu'j
kiujn	kiu'jn
kiun	kiu'n
klarajn	klar'ajn
kolektas	kolekt'as
kolekti	kolekt'i
kompreni	kompren'i
komprenemon	kompren'em'on
komunumo	komun'um'o
konas	kon'as
kontribuojn	kontribu'ojn
koro	kor'o
korpo	korp'o
kredas	kred'as
kunhavigas	kun'hav'ig'as
kunhavigi	kun'hav'ig'i
kuraĝon	kuraĝ'on
kvazaŭ	kvazaŭ
la	la
lasas	las'as
legas	leg'as
leĝeraj	leĝer'aj
liberan	liber'an
liberigi	liber'ig'i
liberigo	liber'ig'o
ligas	lig'as
loĝis	loĝ'is
longa	long'a
malpli	mal'pli
malkaŝas	mal'kaŝ'as
malkaŝi	mal'kaŝ'i
malkaŝo	mal'kaŝ'o
malkaŝu	mal'kaŝ'u
malkovri	mal'kovr'i
mem	mem
menso	mens'o
mi	mi
mia	mi'a
mian	mi'an
movada	mov'ad'a
movado	mov'ad'o
multajn	mult'ajn
multe	mult'e
naiva	naiv'a
ne	ne
ni	ni
nia	ni'a
nin	ni'n
nomojn	nom'ojn
nomon	nom'on
nur	nur
ofte	oft'e
oni	oni
onia	oni'a
paĝo	paĝ'o
pensu	pens'u
pere	per'e
perceptita	percept'it'a
perdis	perd'is
persona	person'a
persone	person'e
petas	pet'as
petis	pet'is
pezon	pez'on
pli	pli
pluraj	plur'aj
por	por
poŝte	poŝt'e
povas	pov'as
povon	pov'on
povus	pov'us
preskaŭ	preskaŭ
pri	pri
projekto	projekt'o
projekton	projekt'on
promesas	promes'as
propran	propr'an
protektita	protekt'it'a
publika	publik'a
publikigos	publik'ig'os
publikigitaj	publik'ig'it'aj
rakonti	rakont'i
respektema	respekt'em'a
restos	rest'os
retadreson	ret'adres'on
retpoŝte	ret'poŝt'e
ricevas	ricev'as
ricevis	ricev'is
rilatas	rilat'as
sama	sam'a
same	sam'e
scias	sci'as
se	se
sed	sed
sekreta	sekret'a
sekretaj	sekret'aj
sekreto	sekret'o
sekretoj	sekret'oj
sekretojn	sekret'ojn
sekreton	sekret'on
sendepende	sen'depend'e
sendi	send'i
sendos	send'os
sendu	send'u
sendantoj	send'ant'oj
senditaj	send'it'aj
sentas	sent'as
sentu	sent'u
septembro	septembr'o
serioza	serioz'a
seriozajn	serioz'ajn
servo	serv'o
sia	si'a
sian	si'an
sin	si'n
simple	simpl'e
skribi	skrib'i
solaj	sol'aj
spaco	spac'o
spacon	spac'on
strebas	streb'as
supozas	supoz'as
supozojn	supoz'ojn
sur	sur
ŝatus	ŝat'us
temas	tem'as
tempo	temp'o
tiel	tiel
timas	tim'as
timigan	tim'ig'an
tio	tio
tion	tio'n
tiu	tiu
tiuj	tiu'j
trovi	trov'i
tuj	tuj
usona	uson'a
utilaj	util'aj
utilos	util'os
uzi	uz'i
venis	ven'is
venos	ven'os
venĝo	venĝ'o
vi	vi
vian	vi'an
vivon	viv'on
vizaĝon	vizaĝ'on
volas	vol'as
volos	vol'os