1982	1982
2020	2020
8-an	8-an
C	C
Ĉar	Ĉar
Ĉiuj	Ĉiu'j
En	En
Esperanta	Esperant'a
Esperanto	Esperant'o
Folio	Foli'o
Ĝi	Ĝi
Homoj	Hom'oj
Kaj	Kaj
Kelkloke	Kelk'lok'e
La	La
Libera	Liber'a
Memore	Memor'e
Movado	Mov'ad'o
Movadon	Mov'ad'on
Ni	Ni
Nu	Nu
Per	Per
Por	Por
Se	Se
Sed	Sed
Talentuloj	Talent'ul'oj
Tamen	Tamen
Tempo	Temp'o
Tia	Tia
Tiaj	Tia'j
Tial	Tial
Tie	Tie
Tišljar	Tišljar
Tiuj	Tiu'j
Treege	Tre'eg'e
UEA	UEA
Zlatko	Zlatko
admirado	admir'ad'o
agado	ag'ad'o
ajn	ajn
akceptojn	akcept'ojn
al	al
alfluo	al'flu'o
aliaj	ali'aj
aliigi	ali'ig'i
almenaŭ	almenaŭ
altaj	alt'aj
alte	alt'e
amarigi	amar'ig'i
amasa	amas'a
ambicioj	ambici'oj
ankaŭ	ankaŭ
ankoraŭ	ankoraŭ
anstataŭigi	anstataŭ'ig'i
antaŭenmarŝon	antaŭ'en'marŝ'on
apartaj	apart'aj
aperas	aper'as
aperintan	aper'int'an
areo	are'o
aspekton	aspekt'on
atingi	ating'i
aŭ	aŭ
aŭtoritata	aŭtoritat'a
aŭtoritato	aŭtoritat'o
aŭtoritaton	aŭtoritat'on
aŭtoritatuloj	aŭtoritat'ul'oj
bagateleco	bagatel'ec'o
baldaŭ	baldaŭ
bato	bat'o
batalos	batal'os
baza	baz'a
bezonas	bezon'as
bona	bon'a
breĉoj	breĉ'oj
cent	cent
certe	cert'e
certigi	cert'ig'i
ĉar	ĉar
ĉasareo	ĉas'are'o
ĉe	ĉe
ĉefe	ĉef'e
ĉiam	ĉiam
ĉio	ĉio
ĉion	ĉio'n
ĉiutaguloj	ĉiu'tag'ul'oj
ĉu	ĉu
da	da
danĝeran	danĝer'an
de	de
defendas	defend'as
defendantoj	defend'ant'oj
devas	dev'as
diktatoras	diktator'as
dolĉon	dolĉ'on
duono	du'on'o
eblas	ebl'as
ebligas	ebl'ig'as
eĉ	eĉ
efektive	efektiv'e
ekdiktatori	ek'diktator'i
ekribelos	ek'ribel'os
eksentas	ek'sent'as
ekonomia	ekonomi'a
ekskomunikitaj	ekskomunik'it'aj
eksponantoj	ekspon'ant'oj
eksteran	ekster'an
ekstero	ekster'o
ekstermos	eksterm'os
ekstermantoj	eksterm'ant'oj
ekstreme	ekstrem'e
ekzistas	ekzist'as
ekzistorajton	ekzist'o'rajt'on
el	el
elbatali	el'batal'i
elpensis	el'pens'is
elstarigu	el'star'ig'u
elektataj	elekt'at'aj
en	en
endanĝerigas	en'danĝer'ig'as
endanĝerigi	en'danĝer'ig'i
enfermita	en'ferm'it'a
eniro	en'ir'o
entreprenas	entrepren'as
entreprenoj	entrepren'oj
epoko	epok'o
escepte	escept'e
esperantistoj	esperant'ist'oj
esprimiĝi	esprim'iĝ'i
estas	est'as
estis	est'is
estus	est'us
establita	establ'it'a
estraroj	estr'ar'oj
eventuala	eventual'a
eventuale	eventual'e
evoluon	evolu'on
fariĝas	far'iĝ'as
fariĝi	far'iĝ'i
feliĉe	feliĉ'e
fenomeno	fenomen'o
flanke	flank'e
flati	flat'i
foje	foj'e
forigi	for'ig'i
forpasis	for'pas'is
forpeli	for'pel'i
gejunuloj	ge'jun'ul'oj
geniaj	geni'aj
grandaj	grand'aj
grizaj	griz'aj
grupo	grup'o
grupoj	grup'oj
gvidan	gvid'an
gvidantoj	gvid'ant'oj
gvidantojn	gvid'ant'ojn
ĝi	ĝi
ĝin	ĝi'n
ĝis	ĝis
ĝisnuna	ĝis'nun'a
harmonie	harmoni'e
havas	hav'as
havi	hav'i
havis	hav'is
hazarde	hazard'e
hierarkia	hierarki'a
historio	histori'o
homo	hom'o
homoj	hom'oj
homojn	hom'ojn
honora	honor'a
ia	ia
ie	ie
ili	ili
ilia	ili'a
iliaj	ili'aj
ilian	ili'an
ilin	ili'n
institucioj	instituci'oj
inteligentaj	inteligent'aj
inter	inter
interalie	inter'ali'e
internacia	inter'naci'a
interesojn	interes'ojn
iom	iom
iu	iu
ja	ja
jam	jam
jarojn	jar'ojn
je	je
jen	jen
junulara	jun'ul'ar'a
junularaj	jun'ul'ar'aj
junularo	jun'ul'ar'o
kaĝo	kaĝ'o
kaj	kaj
kapabla	kapabl'a
kapablaj	kapabl'aj
kapablo	kapabl'o
kapabloj	kapabl'oj
kapitalakumulado	kapital'akumul'ad'o
kaŭzo	kaŭz'o
kaŭzitaj	kaŭz'it'aj
ke	ke
kiam	kiam
kie	kie
kiel	kiel
kio	kio
kiu	kiu
kiuj	kiu'j
kiun	kiu'n
klaso	klas'o
klubo	klub'o
komitatoj	komitat'oj
komitatanojn	komitat'an'ojn
komprenas	kompren'as
komprenos	kompren'os
komprenante	kompren'ant'e
komunumo	komun'um'o
konataj	kon'at'aj
konkurenco	konkurenc'o
konkurencon	konkurenc'on
konscias	konsci'as
konsciiĝas	konsci'iĝ'as
konsideras	konsider'as
kontraŭ	kontraŭ
kontraŭbatalas	kontraŭ'batal'as
kontraŭbatalos	kontraŭ'batal'os
kontrolebla	kontrol'ebl'a
kreskas	kresk'as
kun	kun
kutima	kutim'a
kvalitaj	kvalit'aj
la	la
landa	land'a
li	li
liaj	li'aj
lin	li'n
lingva	lingv'a
lingvo	lingv'o
lingvistoj	lingv'ist'oj
literaturistoj	literatur'ist'oj
malpli	mal'pli
malebligante	mal'ebl'ig'ant'e
malfermo	mal'ferm'o
malgrandaj	mal'grand'aj
malgrandan	mal'grand'an
malmultaj	mal'mult'aj
manieron	manier'on
medio	medi'o
memstare	mem'star'e
membro	membr'o
mezan	mez'an
mezkapablaj	mez'kapabl'aj
mezkapablajn	mez'kapabl'ajn
mezkapablan	mez'kapabl'an
mezkapablula	mez'kapabl'ul'a
mezkapabluloj	mez'kapabl'ul'oj
mezkapablulojn	mez'kapabl'ul'ojn
mezkapablulon	mez'kapabl'ul'on
mildigi	mild'ig'i
momento	moment'o
monda	mond'a
mondon	mond'on
mondeton	mond'et'on
mortodanĝeron	mort'o'danĝer'on
movado	mov'ad'o
multe	mult'e
nacia	naci'a
naciaj	naci'aj
naciajn	naci'ajn
nacio	naci'o
ne	ne
neceso	neces'o
nenion	neni'on
nepre	nepr'e
nestoj	nest'oj
ni	ni
nia	ni'a
nian	ni'an
nin	ni'n
nivelo	nivel'o
niveloj	nivel'oj
normala	normal'a
normale	normal'e
novuloj	nov'ul'oj
nun	nun
nunan	nun'an
nur	nur
ofte	oft'e
ol	ol
oni	oni
ordo	ord'o
organiza	organiz'a
organizaj	organiz'aj
organizo	organiz'o
organizaĵoj	organiz'aĵ'oj
organiziĝas	organiz'iĝ'as
organiziĝi	organiz'iĝ'i
partopreni	part'o'pren'i
per	per
permesas	permes'as
personoj	person'oj
pinton	pint'on
piramido	piramid'o
plej	plej
plene	plen'e
pli	pli
pliampleksiĝu	pli'ampleks'iĝ'u
plu	plu
pluekziston	plu'ekzist'on
popolo	popol'o
por	por
porbatalas	por'batal'as
poresperanta	por'esperant'a
post	post
povas	pov'as
povo	pov'o
povos	pov'os
povus	pov'us
pozicio	pozici'o
pozicion	pozici'on
praktike	praktik'e
prezentas	prezent'as
prezentiĝas	prezent'iĝ'as
pri	pri
privilegiojn	privilegi'ojn
pro	pro
problemo	problem'o
problemon	problem'on
produktas	produkt'as
profesia	profesi'a
profesiaj	profesi'aj
propra	propr'a
publikajn	publik'ajn
punkto	punkt'o
republikigas	re'publik'ig'as
recenzistoj	recenz'ist'oj
reganta	reg'ant'a
regpotencojn	reg'potenc'ojn
regule	regul'e
rekte	rekt'e
relativa	relativ'a
reprezenti	reprezent'i
restas	rest'as
revuo	revu'o
ribeloj	ribel'oj
ribelojn	ribel'ojn
ribelantojn	ribel'ant'ojn
rigidiĝas	rigid'iĝ'as
rilati	rilat'i
rolo	rol'o
rondoj	rond'oj
ruze	ruz'e
samtempe	sam'temp'e
sankta	sankt'a
se	se
sed	sed
sekte	sekt'e
sektomuro	sekt'o'mur'o
sekve	sekv'e
sen	sen
senduban	sen'dub'an
senskrupulaj	sen'skrupul'aj
septembro	septembr'o
serĉas	serĉ'as
serioze	serioz'e
si	si
siaj	si'aj
siajn	si'ajn
sian	si'an
sin	si'n
signifas	signif'as
sistemo	sistem'o
situacion	situaci'on
skalo	skal'o
skuis	sku'is
socia	soci'a
sociaj	soci'aj
socio	soci'o
societo	societ'o
solvojn	solv'ojn
strukturo	struktur'o
strukturoj	struktur'oj
strukturojn	struktur'ojn
strukturon	struktur'on
studenta	student'a
subuloj	sub'ul'oj
subite	subit'e
sukcesas	sukces'as
sukcesis	sukces'is
sukcesoj	sukces'oj
superaj	super'aj
superan	super'an
supertalentitaj	super'talent'it'aj
sur	sur
ŝajnigante	ŝajn'ig'ant'e
ŝanco	ŝanc'o
ŝancon	ŝanc'on
ŝin	ŝi'n
ŝtopitaj	ŝtop'it'aj
talentaj	talent'aj
talentajn	talent'ajn
talentita	talent'it'a
talentitaj	talent'it'aj
talentuloj	talent'ul'oj
tamen	tamen
tavolon	tavol'on
tekstoj	tekst'oj
tempo	temp'o
tia	tia
tian	tia'n
tiam	tiam
tie	tie
tiel	tiel
ties	ties
timas	tim'as
tio	tio
tion	tio'n
tiu	tiu
tiuj	tiu'j
tiujn	tiu'jn
trankvila	trankvil'a
transprenas	trans'pren'as
tre	tre
trovas	trov'as
troviĝas	trov'iĝ'as
truo	tru'o
tuj	tuj
tuŝi	tuŝ'i
unu	unu
unuo	unu'o
ununura	unu'nur'a
unuopaj	unu'op'aj
urbestroj	urb'estr'oj
valoroj	valor'oj
vasta	vast'a
venki	venk'i
vere	ver'e
verkistoj	verk'ist'oj
vivas	viv'as
vivoj	viv'oj
vivojn	viv'ojn
vivon	viv'on
volas	vol'as
zorgas	zorg'as