10000	10000
11-a	11-a
13000	13000
14-a	14-a
14100	14100
2016	2016
2019	2019
3	3
850	850
Albert	Albert
Alia	Ali'a
Ankaŭ	Ankaŭ
Antaŭ	Antaŭ
Bui	Bui
Centra	Centr'a
Charlotte	Charlotte
Dum	Dum
EU	EU
En	En
Ertl	Ertl
Feliĉa	Feliĉ'a
Folio	Foli'o
Garrido	Garrido
Ĝis	Ĝis
Ĝuste	Ĝust'e
Inter	Inter
Interesiĝantoj	Interes'iĝ'ant'oj
Jam	Jam
Jes	Jes
Klára	Klára
La	La
Larsson	Larsson
Laŭ	Laŭ
Libera	Liber'a
Lige	Lig'e
Mi	Mi
Mia	Mi'a
Mung	Mung
Ni	Ni
Nielsen	Nielsen
Nun	Nun
Nuntempe	Nun'temp'e
Oficejo	Ofic'ej'o
Pri	Pri
Pro	Pro
Respondis	Respond'is
Robert	Robert
Roterdamo	Roterdam'o
Scherping	Scherping
Ses	Ses
TEJO	TEJO
Tamen	Tamen
Tiuj	Tiu'j
UEA	UEA
Voldom	Voldom
aĉeto	aĉet'o
aferoj	afer'oj
agado	ag'ad'o
aktivas	aktiv'as
aktivigo	aktiv'ig'o
al	al
aldonan	al'don'an
aligitaj	al'ig'it'aj
aligitajn	al'ig'it'ajn
alia	ali'a
aliaj	ali'aj
aliloke	ali'lok'e
almenaŭ	almenaŭ
ankaŭ	ankaŭ
ankoraŭ	ankoraŭ
anticipe	anticip'e
apartan	apart'an
aparte	apart'e
apartamento	apartament'o
apartamenton	apartament'on
aperis	aper'is
aranĝis	aranĝ'is
asociaj	asoci'aj
asociajn	asoci'ajn
asocio	asoci'o
aŭ	aŭ
aŭgusto	aŭgust'o
baldaŭ	baldaŭ
bilanco	bilanc'o
celo	cel'o
ciferon	cifer'on
ĉambro	ĉambr'o
ĉambrojn	ĉambr'ojn
ĉar	ĉar
ĉeesta	ĉe'est'a
ĉeestan	ĉe'est'an
ĉefe	ĉef'e
ĉiam	ĉiam
ĉirkaŭ	ĉirkaŭ
ĉiuj	ĉiu'j
ĉiujn	ĉiu'jn
ĉu	ĉu
da	da
daŭre	daŭr'e
de	de
decidis	decid'is
demandi	demand'i
demando	demand'o
demandoj	demand'oj
demandojn	demand'ojn
demandanto	demand'ant'o
devas	dev'as
dimanĉo	dimanĉ'o
diri	dir'i
diskutis	diskut'is
diskutejo	diskut'ej'o
divido	divid'o
do	do
domo	dom'o
donas	don'as
doni	don'i
donos	don'os
donu	don'u
du	du
dum	dum
eblas	ebl'as
eblis	ebl'is
eblos	ebl'os
eĉ	eĉ
efektive	efektiv'e
ekoficis	ek'ofic'is
ekonomia	ekonomi'a
ekzaktan	ekzakt'an
el	el
eliranta	el'ir'ant'a
elirantaj	el'ir'ant'aj
elsendo	el'send'o
elsendon	el'send'on
elsendita	el'send'it'a
eltrovi	el'trov'i
en	en
ene	en'e
enhavos	en'hav'os
enspezon	en'spez'on
entreprenos	entrepren'os
esperas	esper'as
estas	est'as
esti	est'i
estis	est'is
estos	est'os
estus	est'us
estonte	est'ont'e
estonteco	est'ont'ec'o
estraro	estr'ar'o
estraron	estr'ar'on
estrarano	estr'ar'an'o
estraranoj	estr'ar'an'oj
etaĝo	etaĝ'o
eŭroj	eŭr'oj
eŭrojn	eŭr'ojn
fakaj	fak'aj
fakajn	fak'ajn
fakte	fakt'e
fari	far'i
fine	fin'e
formo	form'o
formale	formal'e
frizejo	friz'ej'o
funkcias	funkci'as
ĝi	ĝi
ĝis	ĝis
havas	hav'as
havis	hav'is
havu	hav'u
helpi	help'i
honeste	honest'e
horo	hor'o
ideon	ide'on
ili	ili
ilia	ili'a
informoj	inform'oj
informon	inform'on
iniciato	iniciat'o
instancoj	instanc'oj
intencas	intenc'as
interveni	inter'ven'i
internaj	intern'aj
investi	invest'i
iris	ir'is
iu	iu
jam	jam
jare	jar'e
jaro	jar'o
jaroj	jar'oj
julio	juli'o
ĵus	ĵus
ĵusa	ĵus'a
kaj	kaj
kasisto	kas'ist'o
ke	ke
kelkaj	kelk'aj
kialo	kial'o
kialoj	kial'oj
kiel	kiel
kion	kio'n
kiom	kiom
kiu	kiu
kiuj	kiu'j
kiujn	kiu'jn
kiun	kiu'n
klarigas	klar'ig'as
komencis	komenc'is
komenciĝis	komenc'iĝ'is
komitata	komitat'a
komitato	komitat'o
komitatano	komitat'an'o
kompreni	kompren'i
kontakti	kontakt'i
kun	kun
kunsido	kun'sid'o
kunsidoj	kun'sid'oj
kunsidon	kun'sid'on
kvanton	kvant'on
la	la
laboro	labor'o
laboron	labor'on
landa	land'a
landaj	land'aj
landajn	land'ajn
laŭ	laŭ
laŭdinda	laŭd'ind'a
leviĝis	lev'iĝ'is
loĝas	loĝ'as
loĝis	loĝ'is
loĝado	loĝ'ad'o
loĝejo	loĝ'ej'o
luis	lu'is
luantoj	lu'ant'oj
luenspezo	lu'en'spez'o
luigo	lu'ig'o
luita	lu'it'a
lundo	lund'o
malferma	mal'ferm'a
malfermeco	mal'ferm'ec'o
malgranda	mal'grand'a
mandato	mandat'o
mandatperiodo	mandat'period'o
membroj	membr'oj
membrojn	membr'ojn
membraro	membr'ar'o
membrokvanto	membr'o'kvant'o
membronombroj	membr'o'nombr'oj
membronombron	membr'o'nombr'on
minimume	minimum'e
monkolekton	mon'kolekt'on
monate	monat'e
naŭ	naŭ
ne	ne
necerteco	ne'cert'ec'o
neuzata	ne'uz'at'a
necese	neces'e
neniam	neniam
neniu	neniu
ni	ni
nia	ni'a
nombron	nombr'on
nova	nov'a
novan	nov'an
nun	nun
nur	nur
okazis	okaz'is
ol	ol
opinias	opini'as
opiniis	opini'is
pagas	pag'as
pagis	pag'is
parto	part'o
partoprenis	part'o'pren'is
petis	pet'is
planoj	plan'oj
plej	plej
pli	pli
pluraj	plur'aj
por	por
poste	post'e
povis	pov'is
povos	pov'os
povu	pov'u
praktikaj	praktik'aj
preferinde	prefer'ind'e
prezidanto	prezid'ant'o
pri	pri
privateca	privat'ec'a
pro	pro
proksimuman	proksim'um'an
proksimume	proksim'um'e
promesas	promes'as
protokolo	protokol'o
protokoloj	protokol'oj
protokolojn	protokol'ojn
provon	prov'on
publikigas	publik'ig'as
publikigi	publik'ig'i
publikigos	publik'ig'os
publikigita	publik'ig'it'a
rakonti	rakont'i
raporto	raport'o
raportitan	raport'it'an
reluis	re'lu'is
resumojn	re'sum'ojn
regas	reg'as
rekte	rekt'e
respondis	respond'is
respondoj	respond'oj
respondojn	respond'ojn
respondeca	respond'ec'a
reta	ret'a
retan	ret'an
ricevi	ricev'i
rilato	rilat'o
saman	sam'an
scias	sci'as
scivolis	sci'vol'is
se	se
sed	sed
sekcioj	sekci'oj
sekciojn	sekci'ojn
semajnfino	semajn'fin'o
sen	sen
sendi	send'i
senditaj	send'it'aj
septembro	septembr'o
si	si
siaj	si'aj
sian	si'an
spekti	spekt'i
starigis	star'ig'is
stokejo	stok'ej'o
strebas	streb'as
strebi	streb'i
sumo	sum'o
supozeble	supoz'ebl'e
taksi	taks'i
tamen	tamen
taskoj	task'oj
taskojn	task'ojn
teamo	team'o
teksta	tekst'a
temis	tem'is
tera	ter'a
teretaĝo	ter'etaĝ'o
tie	tie
tio	tio
tion	tio'n
tiu	tiu
tiun	tiu'n
travideblo	tra'vid'ebl'o
tradicie	tradici'e
transpreni	trans'pren'i
troigitan	tro'ig'it'an
troviĝas	trov'iĝ'as
tuta	tut'a
tuton	tut'on
unu	unu
unua	unu'a
unuan	unu'an
uzata	uz'at'a
uzataj	uz'at'aj
uzatajn	uz'at'ajn
veni	ven'i
venonta	ven'ont'a
vizito	vizit'o
volontulo	volont'ul'o
volontuloj	volont'ul'oj